111111111
1000P0001
100000001
1000E0001
111111111
