1111111111111111111111111111
100000000000000000000000C001
100001110C000000000011100001
1000011100000000000011100001
1000000000001E10000000000001
100000010000111000001000C001
1000000010000000000100000001
10000000011111111110000C0001
100P000000000000000000000001
1111111111111111111111111111
