111111111111111111111111111111111111111111111111111111111111
100000000000000000011000000000000000000110000000000000000001
100C0000000P0C0000011000000000000000000110000000000000000001
100000000000000000000000000000000000000110000000000000000001
100000000000000000000000000000000000000110000000000000000001
100000000000000000000000000000000000000110000000000000000001
100000000000000000000000000000000000000110000000000000000001
100000000000000000000000000000000000000110000000000000000001
100000000000000000000000000000000000000110000000000000000001
100000000000000000000000000000000000000110000000000000000001
100000000000000000000000000000000000000110000000000000000001
100000000000000000000000000000000000000110000000000000000001
100000000000000000000000000000000000000110000000000000000001
100000000000000000000000000000000000000110000000000000000001
100000000000000000000000000000000000000110000000000000000001
100000000000000000000000000000000000000110000000000000000001
100000000000000000000000000000000000000110000000000000000001
100000000000000000000000000000000000000110000000000000000001
100000000000000000000000000000000000000110000000000000000001
100000000000000000000000000000000000000110000000000000000001
100000000000000000000000000000000000000110000000000000000001
100000000000000000000000000000000000000110000000000000000001
100000000000000000000000000000000000000110000000000000000001
100000000000000000000000000000000000000110000000000000000001
100000000000000000000000000000000000000110000000000000000001
100000000000000000000000000000000000000110000000000000000001
100000000000000000000000000000000000000110000000000000000001
100000000000000000000000000000000000000110000000000000000001
100000000000000000000000000000000000000110000000000000000001
100000000000000000000000000000000000000110000000000000000001
10000E000000000000000000000000000000000110000000000000000001
111111111111111111111111111111111111111111111111111111111111
