11111111111111
100000E0000001
10000000000001
11111101111111
10000000000001
10000C0100P001
11111111111111
