11111111111
11111P01111
11111C01111
11111E01111
111111111111
