11111111111111111111
10000000000000000001
100C0000000P0C000001
10000000000000000001
10000E00000000000001
11111111111111111111
