111111111
1000000P1
1000000E1
10000C001
100000001
111111111
