111111111
1000000P1
1111E1111
10000C001
100000001
111111111
