11111111111111111111111111111111
10000000000000000000000000000001
1000E00000000000000000000C000001
10000001111110000001111110000001
10000001111110000001111110000001
10000001111110000001111110000001
10000001111110000001111110000001
10000000000000000000000000000001
10000000000000000000000000000001
10000000000001111110000000000001
10000000000001111110000000000001
10000000000001111110000000000001
10000000000001111110000000000001
10000000000000000000000000000001
1000000C0000000000000000C0000001
10000000000000000000000000000001
10000000100000000000001000000001
10000000010000000000010000000001
100000000011000C0001100000000001
10000000000011111110000000000001
10000000000000000000000000000001
10000000000000000000000000000001
10000000000000000000000000000001
10000000000000000000000000000001
10000000000000000000000000000001
1000000000000000000000000000P001
11111111111111111111111111111111
