111111
1001C1
100001
1P0011
1000E1
111111
